#############################
#*************#*************#
#*####*######*#*######*####*#
#*####*######*#*######*####*#
#***************************#
#*####*#*###########*#*####*#
#******#******#******#******#
######*######*#*######*######
######*#*************#*######
######*#*#####*#####*#*######
*********#*********#*********
######*#*###########*#*######
######*#*************#*######
######*#*###########*#*######
#*************#*************#
#*####*######*#*######*####*#
#****#*****************#****#
####*#*#*###########*#*#*####
#******#******#******#******#
#*###########*#*###########*#
#***************************#
#############################