######################
#*********##*********#
#*###*###*##*###*###*#
#********************#
#*###*#*######*#*###*#
#*****#***##***#*****#
#####*###*##*###*#####
#####*#********#*#####
#####*#*##**##*#*#####
********#****#********
#####*#*######*#*#####
#####*#********#*#####
#####*#*######*#*#####
#*********##*********#
#*###*###*##*###*###*#
#***#************#***#
###*#*#*######*#*#*###
#*****#***##***#*****#
#*#######*##*#######*#
#********************#
######################